ID,NOx,SO2,PM10,PM2.5,NMVOC,NH3
1038,0,0,0,0,0,0
1127,0,0,0,0,0,0
1128,0,0,0,0,0,0
1129,0,0,0,0,0,0
1217,0,0,0,0,0,0
1218,0,0,0,0,0,0
1219,0,0,0,0,0,0
1307,0,0,0,0,0,0
1308,0,0,0,0,0,0
1309,0,0,0,0,0,0
1310,0,0,0,0,0,0
1397,0,0,0,0,0,1.60074226581485
1398,0,0,0,0,0,3.2014845316297
1399,0,0,0,0,0,0
1487,0,0,0,0,0,0
1488,0,0,0,0,0,1.60074226581485
1577,0,0,0,0,0,0
1578,0,0,0,0,0,0
1666,0,0,0,0,0,0
1667,0,0,0,0,0,0
1668,0,0,0,0,0,0
1669,0,0,0,0,0,0.722699648580941
1755,0,0,0,0,0,0
1756,0,0,0,0,0,0
1757,0,0,0,0,0,0
1758,0,0,0,0,0,3.2014845316297
1759,0,0,0,0,0,0
1760,0,0,0,0,0,0
1846,0,0,0,0,0,0
1847,0,0,0,0,0,1.60074226581485
1848,0,0,0,0,0,4.80222679744455
1849,0,0,0,0,0,0
1850,0,0,0,0,0,0
1851,0,0,0,0,0,0
1935,0,0,0,0,0,0
1936,0,0,0,0,0,0
1937,0,0,0,0,0,3.63846877086077
1938,0,0,0,0,0,5.23921103667562
1939,0,0,0,0,0,0
1940,0,0,0,0,0,0
1941,0,0,0,0,0,0
2026,0,0,0,0,0,0
2027,0,0,0,0,0,0
2028,0,0,0,0,0,2.03772650504592
2029,0,0,0,0,0,0
2030,0,0,0,0,0,0
2031,0,0,0,0,0,0
2117,0,0,0,0,0,0
