ID,NOx,SO2,PM10,PM2.5,NMVOC,NH3
5354,0,0,0,0,0,0
5355,0,0,0,0,0,0
5443,0,0,0,0,0,0
5444,0,0,0,0,0,0
5445,0,0,0,0,0,0
5533,0,0,0,0,0,0
5534,0,0,0,0,0,0
5535,0,0,0,0,0,0
5622,0,0,0,0,0,0
5623,0,0,0,0,0,0
5624,0,0,0,0,0,0
5625,0,0,0,0,0,0
5626,0,0,0,0,0,0
5711,0,0,0,0,0,0
5712,0,0,0,0,0,0
5713,0,0,0,0,0,0
5714,0,0,0,0,0,0
5715,0,0,0,0,0,0
5716,0,0,0,0,0,0
5799,0,0,0,0,0,0
5800,0,0,0,0,0,0
5801,0,0,0,0,0,0
5802,0,0,0,0,0,0
5803,0,0,0,0,0,0
5804,0,0,0,0,0,0
5805,0,0,0,0,0,0
5806,0,0,0,0,0,0
5889,0,0,0,0,0,0
5890,0,0,0,0,0,0
5891,0,0,0,0,0,0
5892,0.0511501202250223,7.91703854262722e-05,0.00230854792663359,0.00230854792663359,0.00767196333678539,1.81537189512471e-05
5893,14.3777439386771,2.96581630597907,1.72375468224063,0.71555466495673,16.2481685575365,0
5894,0,0,0,0,0,0
5895,0,0,0,0,0,0
5896,0,0,0,0,0,0
5897,0,0,0,0,0,0
5979,0,0,0,0,0,0
5980,0,0,0,0,0,0
5981,0,0,0,0,0,0
5982,15.1987296674764,7.59572663881095,0.901977444843855,0.733876769177185,1.28096100375921,0.904888336640865
5983,375.48199279782,797.505173610981,30.3237367735236,28.7913527775271,118.25313314114,0.433194475141728
5984,5.47829651612271,2.72868228706384,0.324851532134204,0.264463819800649,0.462922563697228,0.325074438928352
5985,0,0,0,0,0,0
5986,0,0,0,0,0,0
5987,0,0,0,0,0,0
6070,0,0,0,0,0,0
6071,0,0,0,0,0,0
6072,0,0,0,0,0,0
6073,0,0,0,0,0,0
6074,0,0,0,0,0,0
6075,0,0,0,0,0,0
6076,0,0,0,0,0,0
6160,0,0,0,0,0,0
6161,0,0,0,0,0,0
6162,0,0,0,0,0,0
6163,0,0,0,0,0,0
6164,0,0,0,0,0,0
6165,0,0,0,0,0,0
