ID,NOx,SO2,PM10,PM2.5,NMVOC,NH3
2101,0,0,0,0,0,0
2102,0,0,0,0,0,0
2103,0,0,0,0,0,0
2104,0,0,0,0,0,0
2191,6178.03867951927,5516.95777189671,381.625671079444,160.123910181373,153.316345652233,0
2192,0,0,0,0,0,0
2193,0,0,0,0,0,0
2194,0,0,0,0,0,0
2279,0,0,0,0,0,0
2280,0,0,0,0,0,0
2281,0,0,0,0,0,0
2282,0,0,0,0,0,0
2283,0,0,0,0,0,0
2284,0,0,0,0,0,0
2367,0,0,0,0,0,0
2368,0,0,0,0,0,0
2369,0,0,0,0,0,0
2370,0,0,0,0,0,0
2371,0,0,0,0,0,0
2372,0,0,0,0,0,0
2373,0,0,0,0,0,0
2374,0,0,0,0,0,0
2375,0,0,0,0,0,0
2457,0,0,0,0,0,0
2458,0,0,0,0,0,0
2459,0,0,0,0,0,0
2460,0,0,0,0,0,0
2461,7712.76475813158,7166.86573905222,569.995836534017,239.160960725647,191.140011410237,0
2462,0,0,0,0,0,0
2463,0,0,0,0,0,0
2464,0,0,0,0,0,0
2465,0,0,0,0,0,0
2467,0,0,0,0,0,0
2468,0,0,0,0,0,0
2469,0,0,0,0,0,0
2546,0,0,0,0,0,0
2547,0,0,0,0,0,0
2548,0,0,0,0,0,0
2549,0,0,0,0,0,0
2550,0,0,0,0,0,0
2551,0,0,0,0,0,0
2552,0,0,0,0,0,0
2553,0,0,0,0,0,0
2554,0,0,0,0,0,0
2555,0,0,0,0,0,0
2556,0,0,0,0,0,0
2557,0,0,0,0,0,0
2558,0,0,0,0,0,0
2559,0,0,0,0,0,0
2633,0,0,0,0,0,0
2635,0,0,0,0,0,0
2636,0,0,0,0,0,0
2637,0,0,0,0,0,0
2638,0,0,0,0,0,0
2639,0,0,0,0,0,0
2640,0,0,0,0,0,0
2641,0,0,0,0,0,0
2642,0,0,0,0,0,0
2643,0,0,0,0,0,0
2644,0,0,0,0,0,0
2645,0,0,0,0,0,0
2646,239.748804632296,953.927560564905,184.331005476505,102.469351597338,14.0109035508423,2.35427223374862
2647,0,0,0,0,0,0
2648,0,0,0,0,0,0
2649,0,0,0,0,0,0
2650,0,0,0,0,0,0
2723,0,0,0,0,0,0
2724,0,0,0,0,0,0
2725,0,0,0,0,0,0
2726,0,0,0,0,0,0
2727,0,0,0,0,0,0
2728,0,0,0,0,0,0
2729,0,0,0,0,0,0
2730,0,0,0,0,0,0
2731,0,0,0,0,0,0
2732,0,0,0,0,0,0
2733,0,0,0,0,0,0
2734,0,0,0,0,0,0
2735,0,0,0,0,0,0
2736,0,0,0,0,0,0
2737,0,0,0,0,0,0
2738,0,0,0,0,0,0
2739,0,0,0,0,0,0
2813,0,0,0,0,0,0
2814,0,0,0,0,0,0
2815,0,0,0,0,0,0
2816,0,0,0,0,0,0
2817,0,0,0,0,0,0
2818,9.78664587038591,5.59427503444328,4.55772480937909,1.91234702829126,0.279854270666756,0
2819,0,0,0,0,0,0
2820,0,0,0,0,0,0
2821,0,0,0,0,0,0
2822,0,0,0,0,0,0
2823,0,0,0,0,0,0
2824,0,0,0,0,0,0
2825,0,0,0,0,0,0
2826,0,0,0,0,0,0
2827,0,0,0,0,0,0
2828,0,0,0,0,0,0
2829,0,0,0,0,0,0
2904,0,0,0,0,0,0
2905,0,0,0,0,0,0
2906,0,0,0,0,0,0
2907,0,0,0,0,0,0
2908,98.8101523031345,3.73531097733688,1.4203888200629,0.59597199319181,2.82552812000077,0
2909,15.8117186424696,0.0601929263614593,0.118825571380427,0.0498572726125885,0.452144386062452,0
2910,18.0626148121141,0.243290156027549,0.260301093639107,0.109218095365773,0.516509942377163,0
2911,0,0,0,0,0,0
2912,0,0,0,0,0,0
2913,0,0,0,0,0,0
2914,0,0,0,0,0,0
2915,0,0,0,0,0,0
2916,0,0,0,0,0,0
2917,0,0,0,0,0,0
2918,0,0,0,0,0,0
2995,0,0,0,0,0,0
2996,0,0,0,0,0,0
2997,0,0,0,0,0,0
2998,14.3290240590099,29.152185259512,2.30067818123383,0.999284462556106,9.75148675061488,0.0536322428047181
2999,11.0513801115982,0.126460472061447,0.154331680601566,0.0647550572079863,0.316020009506121,0
3000,6.83802369702233,0.0688796726584611,0.0482467065901564,0.0202435315494828,0.195536873396311,0
3001,0,0,0,0,0,0
3002,0,0,0,0,0,0
3003,0,0,0,0,0,0
3004,0,0,0,0,0,0
3005,0,0,0,0,0,0
3006,0,0,0,0,0,0
3007,0,0,0,0,0,0
3086,0,0,0,0,0,0
3087,0,0,0,0,0,0
3088,0,0,0,0,0,0
3089,5.8905191567727,0.146881773520308,0.0433642554442064,0.0181949346441759,0.168442484207531,0
3090,0,0,0,0,0,0
3091,0,0,0,0,0,0
3092,0,0,0,0,0,0
3093,0,0,0,0,0,0
3094,0,0,0,0,0,0
3095,0,0,0,0,0,0
3096,0,0,0,0,0,0
3097,0,0,0,0,0,0
3176,0,0,0,0,0,0
3177,0,0,0,0,0,0
3178,0,0,0,0,0,0
3179,0,0,0,0,0,0
3180,0,0,0,0,0,0
3181,0,0,0,0,0,0
3182,0,0,0,0,0,0
3183,0,0,0,0,0,0
3184,0,0,0,0,0,0
3185,0,0,0,0,0,0
3186,0,0,0,0,0,0
3187,0,0,0,0,0,0
3267,0,0,0,0,0,0
3269,0,0,0,0,0,0
3270,0,0,0,0,0,0
3271,0,0,0,0,0,0
3272,0,0,0,0,0,0
3273,0,0,0,0,0,0
3274,0,0,0,0,0,0
3275,0,0,0,0,0,0
3276,0,0,0,0,0,0
3277,0,0,0,0,0,0
3278,0,0,0,0,0,0
3360,0,0,0,0,0,0
3361,0,0,0,0,0,0
3362,0,0,0,0,0,0
3363,0,0,0,0,0,0
3364,0,0,0,0,0,0
3365,0,0,0,0,0,0
3366,0,0,0,0,0,0
3367,0,0,0,0,0,0
3368,0,0,0,0,0,0
3451,0,0,0,0,0,0
3452,0,0,0,0,0,0
3453,0,0,0,0,0,0
3454,0,0,0,0,0,0
3455,0,0,0,0,0,0
3456,0,0,0,0,0,0
3457,0,0,0,0,0,0
3458,0,0,0,0,0,0
3542,0,0,0,0,0,0
3543,0,0,0,0,0,0
3544,0,0,0,0,0,0
3545,0,0,0,0,0,0
3546,0,0,0,0,0,0
3547,0,0,0,0,0,0
3548,0,0,0,0,0,0
3549,0,0,0,0,0,0
3633,0,0,0,0,0,0
3635,0,0,0,0,0,0
3636,0,0,0,0,0,0
